00;07;00;00;08;00;00;00;00;00;00;00;00;00;00;00;00;00;00;00;00;00;00;08;00;00;00;00;00;07;00;00;00;00;00;00;00;00;00;00;00;00;00;00;00;00;00;00;00;00;00;00;00;00;00;00;00;00;00;00;00;00;00;00;08;00;00;00;00;00;00;00;02;02;02;02;02;02;02;02;02;02;02;02;02;02;02;02;02;02;02;02;02;02;02;02;02;02;02;02
00;00;00;00;00;00;00;00;00;00;00;07;00;00;08;00;00;00;00;00;00;00;00;00;00;08;00;00;00;00;00;00;00;00;00;00;00;00;00;08;08;07;08;00;00;00;00;00;00;07;00;00;00;00;00;00;00;00;00;00;00;00;00;00;00;00;00;00;00;10;00;02;02;02;02;02;02;02;02;02;02;02;02;02;02;02;02;02;02;02;02;02;02;02;02;02;02;02;02;02
00;00;00;00;08;00;00;00;00;00;07;07;00;00;00;00;00;00;00;00;00;00;00;00;00;00;00;00;00;00;00;00;00;00;00;00;08;00;00;00;00;00;00;00;00;00;00;00;00;00;00;00;00;00;00;00;00;00;08;00;00;00;00;00;00;00;00;00;00;00;00;00;02;02;02;02;02;02;02;02;02;02;02;02;02;02;02;02;02;02;02;02;02;02;02;02;02;02;02;02
00;00;00;00;00;00;00;00;00;00;00;08;00;07;00;00;00;00;00;00;00;00;00;00;00;00;00;00;00;00;00;00;07;00;00;00;00;00;00;00;00;00;00;00;00;00;00;08;00;00;00;00;00;00;00;00;00;00;00;00;00;00;00;00;00;00;00;00;00;00;10;02;02;02;02;02;02;02;02;02;02;02;02;02;02;02;02;02;02;02;02;02;02;02;02;02;02;02;02;02
00;00;00;00;00;00;00;00;00;00;07;07;07;07;00;00;00;08;00;00;00;00;00;00;00;00;00;00;00;00;00;00;00;00;00;00;08;00;00;00;00;00;00;00;00;00;00;00;00;08;00;00;00;08;00;00;00;00;00;00;00;00;00;00;00;00;00;10;00;00;02;02;02;02;02;02;02;02;02;02;02;02;02;02;02;02;02;02;02;02;02;02;02;02;02;02;02;02;02;02
00;00;00;00;00;00;00;00;00;00;00;00;07;00;08;00;00;00;00;00;00;00;00;00;00;00;00;00;00;00;00;00;00;00;00;00;00;00;00;00;00;00;00;00;00;00;00;00;00;00;00;00;00;00;00;00;00;00;00;00;00;00;00;00;00;00;10;00;02;02;02;02;02;02;02;02;02;02;02;02;02;02;02;02;02;02;02;02;02;02;02;02;02;02;02;02;02;02;02;02
00;00;00;00;00;00;00;07;00;00;00;00;00;00;00;00;00;00;08;00;00;00;08;00;00;00;00;00;00;00;00;00;00;00;00;00;00;00;00;00;00;00;00;00;00;00;00;00;00;00;00;00;00;00;00;00;07;00;00;00;00;00;00;00;00;00;00;10;00;02;02;02;02;02;02;02;02;02;02;02;02;02;02;02;02;02;02;02;02;02;02;02;02;02;02;02;02;02;02;02
00;00;00;00;00;00;00;00;00;00;00;00;00;00;00;00;00;00;00;00;00;00;00;00;00;00;00;00;00;00;00;00;00;00;00;00;00;00;00;00;00;00;00;00;00;00;00;00;00;00;08;00;00;00;00;07;07;00;00;00;00;00;00;00;00;00;00;00;02;02;02;02;02;02;02;02;02;02;02;02;02;02;02;02;02;02;02;02;02;02;02;02;02;02;02;02;02;02;02;02
00;00;00;08;00;00;00;00;00;00;00;00;00;00;00;00;00;00;00;00;00;00;00;00;00;10;00;00;00;00;07;00;00;00;00;00;00;00;00;00;00;00;00;00;00;00;00;00;00;00;00;00;00;00;07;00;00;00;00;00;00;00;07;00;00;00;00;00;02;02;02;02;02;02;02;02;02;02;02;02;02;02;02;02;02;02;02;02;02;02;02;02;02;02;02;02;02;02;02;02
00;00;00;00;00;00;00;00;00;08;00;00;00;00;00;00;00;00;00;00;00;08;00;00;00;00;00;00;00;00;00;00;00;00;00;00;00;00;00;00;00;00;00;00;00;00;00;00;00;00;00;00;08;00;00;07;00;07;00;00;00;00;00;00;00;00;00;02;02;02;02;02;02;02;02;02;02;02;02;02;02;02;02;02;02;02;02;02;02;02;02;02;02;02;02;02;02;02;02;02
00;00;00;00;00;00;00;00;00;00;00;00;00;00;00;08;00;00;00;07;08;00;00;00;00;00;00;00;00;00;00;00;00;00;00;00;00;00;00;00;00;00;00;00;00;00;00;00;00;00;00;00;00;00;00;00;00;07;00;00;00;00;00;00;00;00;00;00;02;02;02;02;02;02;02;02;02;02;02;02;02;02;02;02;02;02;02;02;02;02;02;02;02;02;02;02;02;02;02;02
00;00;00;00;00;00;00;00;00;00;00;00;00;00;00;00;00;00;00;00;08;00;00;00;00;00;00;00;00;00;00;00;00;00;00;00;00;08;00;08;00;00;00;00;00;00;00;00;07;00;00;00;00;00;00;00;00;00;00;00;00;00;00;00;00;10;00;07;00;02;02;02;02;02;02;02;02;02;02;02;02;02;02;02;02;02;02;02;02;02;02;02;02;02;02;02;02;02;02;02
00;00;00;00;00;00;00;00;00;00;00;00;00;00;00;00;00;00;00;00;00;00;00;00;00;00;00;00;00;00;00;00;00;00;00;00;00;08;00;00;08;08;00;00;00;00;00;00;00;00;00;00;00;00;08;00;00;00;00;08;00;00;00;00;00;00;00;10;00;00;02;02;02;02;02;02;02;02;02;02;02;02;02;02;02;02;02;02;02;02;02;02;02;02;02;02;02;02;02;02
00;00;00;07;00;00;00;10;00;00;00;00;00;00;00;00;00;00;00;00;00;00;00;00;07;00;00;00;00;00;00;00;00;00;00;00;00;00;08;08;08;08;08;00;00;08;00;00;00;00;00;00;00;00;00;00;00;00;00;00;00;00;00;00;00;00;00;00;00;02;02;02;02;02;02;02;02;02;02;02;02;02;02;02;02;02;02;02;02;02;02;02;02;02;02;02;02;02;02;02
00;00;00;00;00;00;00;00;00;00;00;00;00;00;00;00;00;00;00;00;00;00;00;07;00;00;00;00;08;00;00;00;00;00;00;00;00;08;08;08;08;00;08;00;00;00;00;00;00;00;00;00;00;00;00;00;00;00;00;00;00;00;00;00;00;00;00;00;00;00;00;02;02;02;02;02;02;02;02;02;02;02;02;02;02;02;02;02;02;02;02;02;02;02;02;02;02;02;02;02
00;00;00;00;00;00;00;00;00;00;00;00;00;00;00;00;00;07;00;00;00;08;00;00;00;00;00;00;00;00;00;00;00;00;00;00;00;00;08;00;00;08;00;08;00;00;00;00;00;00;00;00;08;00;00;00;00;00;00;00;00;00;00;00;00;00;00;00;00;10;02;02;02;02;02;02;02;02;02;02;02;02;02;02;02;02;02;02;02;02;02;02;02;02;02;02;02;02;02;02
00;00;00;00;07;00;00;00;00;00;00;07;00;00;00;00;00;00;00;00;00;00;00;00;00;08;00;00;00;00;00;00;00;00;00;00;00;00;00;00;00;00;00;00;00;00;00;00;00;00;00;00;00;00;00;00;00;00;00;00;00;00;00;00;00;00;00;00;00;00;10;00;02;02;02;02;02;02;02;02;02;02;02;02;02;02;02;02;02;02;02;02;02;02;02;02;02;02;02;02
00;00;00;00;00;00;00;00;00;00;00;00;00;00;00;00;00;00;00;00;00;00;00;00;00;00;00;00;00;00;00;00;00;00;00;00;00;00;00;00;00;00;00;00;00;00;00;00;00;00;00;00;00;00;00;00;00;00;00;00;00;00;00;00;00;00;00;00;00;00;00;00;00;02;02;02;02;02;02;02;02;02;02;02;02;02;02;02;02;02;02;02;02;02;02;02;02;02;02;02
00;00;00;00;00;00;00;00;00;00;00;00;00;00;00;00;00;00;00;00;00;00;00;00;00;00;08;00;00;00;00;00;00;00;00;00;00;00;00;00;00;00;00;00;00;00;00;00;00;00;00;00;07;00;00;00;00;00;00;00;00;00;00;07;00;00;00;00;00;10;00;00;00;00;00;02;02;02;02;02;02;02;02;02;02;02;02;02;02;02;02;02;02;02;02;02;02;02;02;02
00;00;00;00;00;00;00;00;00;00;00;00;00;00;00;00;00;00;00;00;00;00;00;00;00;08;00;00;00;00;00;00;00;00;07;00;00;00;00;00;00;00;00;00;00;00;00;00;00;00;00;00;00;00;00;00;00;00;00;08;00;00;00;00;00;00;00;00;00;07;00;00;00;10;00;00;02;02;02;02;02;02;02;02;02;02;02;02;02;02;02;02;02;02;02;02;02;02;02;02
00;00;00;00;00;08;00;00;08;00;00;00;00;00;00;00;00;00;00;00;00;00;00;00;00;00;00;00;00;00;00;00;00;00;00;00;00;00;00;00;00;00;00;00;00;00;00;00;00;00;00;00;00;00;00;00;00;08;00;00;00;00;00;00;00;00;00;00;00;00;00;00;00;00;00;00;00;02;02;02;02;02;02;02;02;02;02;02;02;02;02;02;02;02;02;02;02;02;02;02
00;00;07;00;00;00;00;00;00;00;00;00;00;00;00;00;00;00;00;00;00;00;00;00;00;00;00;00;00;00;00;00;00;00;00;00;00;00;00;00;00;00;00;00;08;00;00;00;00;00;00;00;00;00;00;00;00;07;00;00;00;00;00;00;00;00;00;00;00;00;00;00;00;00;10;00;00;00;02;02;02;02;02;02;02;02;02;02;02;02;02;02;02;02;02;02;02;02;02;02
00;00;00;00;00;00;00;00;00;00;00;00;00;00;00;00;00;00;00;10;00;00;00;00;00;00;00;00;00;00;00;00;07;00;00;00;00;00;00;00;00;00;00;00;00;00;00;00;00;00;00;00;00;00;00;00;00;00;00;00;00;00;00;00;08;00;00;00;00;00;00;10;00;00;00;10;00;02;02;02;02;02;02;02;02;02;02;02;02;02;02;02;02;02;02;02;02;02;02;02
00;00;00;00;00;00;00;00;00;00;00;00;08;00;00;00;00;00;00;00;00;08;00;00;00;00;00;00;00;00;00;00;00;00;00;00;00;00;00;00;00;00;00;01;01;01;01;01;01;01;01;01;01;01;01;01;01;00;00;00;00;00;00;00;00;00;00;00;00;00;00;00;00;00;10;00;00;10;02;02;02;02;02;02;02;02;02;02;02;02;02;02;02;02;02;02;02;02;02;02
00;00;00;00;07;00;00;00;00;00;08;00;00;00;00;00;00;00;00;00;00;00;00;00;00;00;00;00;00;00;00;00;00;00;00;00;00;00;00;00;00;00;00;01;01;01;01;01;01;01;01;01;01;01;01;01;01;00;00;00;00;08;00;00;00;00;00;00;00;00;00;00;00;00;00;00;00;00;00;00;02;02;02;02;02;02;02;02;02;02;02;02;02;02;02;02;02;02;02;02
00;00;00;00;00;00;00;00;00;00;00;00;00;00;00;03;03;03;03;03;03;03;03;03;00;00;00;00;00;00;00;00;00;00;00;00;08;00;00;00;00;00;00;01;01;01;01;01;01;01;01;01;01;01;01;01;01;00;00;00;00;00;00;00;00;00;00;00;00;00;00;00;00;00;00;00;00;00;00;10;00;02;02;02;02;02;02;02;02;02;02;02;02;02;02;02;02;02;02;02
00;00;00;00;00;00;00;00;00;00;00;00;00;00;00;03;05;14;15;16;05;05;05;03;00;00;00;00;00;00;00;00;00;00;00;00;00;00;00;00;00;00;00;01;01;01;1;1;1;1;1;1;1;1;1;1;1;0;0;0;0;0;0;0;0;0;0;0;0;8;0;0;0;17;0;0;0;0;17;17;0;0;10;2;2;2;2;2;2;2;2;2;2;2;2;2;2;2;2;2
00;00;00;00;00;00;00;00;00;00;00;00;00;00;00;03;05;05;05;05;05;5;5;3;1;1;1;1;1;1;1;1;1;1;1;1;1;1;1;1;1;1;1;1;1;1;1;1;1;10;10;10;1;1;1;1;1;17;17;17;17;17;17;17;17;17;17;17;17;17;17;17;0;0;0;0;0;0;0;0;10;0;0;0;10;2;2;2;2;2;2;2;2;2;2;2;2;2;2;2
00;00;00;00;00;00;00;00;00;00;07;00;00;00;00;03;05;05;05;05;05;5;5;5;1;1;1;1;1;1;1;1;1;1;1;1;1;1;1;1;1;1;1;1;1;1;1;1;1;10;21;10;1;1;1;1;1;17;17;17;17;17;17;17;17;17;17;17;17;17;17;17;0;0;0;0;0;0;0;0;0;0;0;10;0;0;10;2;2;2;2;2;2;2;2;2;2;2;2;2
00;00;00;00;00;00;00;00;00;00;00;00;00;00;00;03;05;05;05;05;05;5;5;3;1;1;1;1;1;1;1;1;1;1;1;1;1;1;1;1;1;1;1;1;1;1;1;1;1;10;1;10;1;1;1;1;1;17;17;17;17;17;17;17;17;17;17;17;17;17;17;0;0;0;0;0;0;0;0;0;0;0;0;0;0;0;0;10;0;10;0;2;2;2;2;2;2;2;2;2
00;00;00;00;00;00;07;00;00;00;00;00;00;00;00;03;05;05;05;05;16;14;5;3;0;0;0;0;0;0;0;0;0;0;0;0;0;0;0;0;0;0;0;1;1;1;1;1;1;1;1;1;1;1;1;1;1;0;0;0;0;0;0;0;0;0;0;0;0;0;7;17;17;17;17;0;0;0;0;0;0;0;0;0;0;0;0;0;0;0;10;0;0;0;10;2;2;2;2;2
00;00;00;00;00;00;00;00;00;00;00;00;00;00;00;03;05;05;05;05;05;5;5;3;0;0;0;0;0;0;0;0;0;0;0;0;0;0;0;0;0;0;0;1;1;1;1;1;1;1;1;1;1;1;1;1;1;0;0;0;0;0;0;0;0;0;0;8;0;0;0;0;0;0;0;17;17;17;0;0;0;0;0;0;0;0;0;0;0;0;0;0;0;0;0;0;0;0;2;2
00;00;07;00;00;00;00;00;00;00;00;00;00;00;00;03;03;03;03;03;03;3;3;3;0;0;0;8;0;0;0;0;0;0;0;7;0;0;0;8;0;0;0;1;1;1;1;1;1;1;1;1;1;1;1;1;1;0;0;0;0;0;0;0;0;0;0;0;0;0;0;0;0;0;0;0;17;17;17;0;0;0;0;0;0;0;0;0;0;0;0;0;0;0;0;10;0;0;0;10
00;00;00;00;00;00;00;00;00;00;00;00;00;00;00;00;00;00;00;00;00;0;0;0;0;0;0;0;0;0;0;0;0;8;0;0;0;0;0;0;0;0;0;1;1;1;1;1;1;1;1;1;1;1;1;1;1;0;0;0;0;0;0;0;0;8;0;0;0;0;0;7;0;0;0;0;0;17;17;17;17;0;0;0;0;0;0;0;0;0;0;0;0;0;8;0;0;0;0;0
00;00;00;00;00;00;00;00;00;00;00;00;00;00;00;00;00;00;00;00;00;00;00;00;00;00;00;00;00;00;00;00;00;00;00;00;00;00;00;00;00;08;00;00;00;00;10;01;01;01;10;08;00;00;00;00;00;00;00;00;08;00;00;00;00;00;00;00;00;00;00;00;00;00;00;00;00;00;17;17;17;00;00;00;00;00;00;00;00;00;00;00;00;00;00;00;00;00;00;00
00;00;00;00;00;00;00;00;00;00;00;00;00;00;00;00;00;00;00;00;00;00;00;00;00;00;00;00;00;00;00;07;00;00;00;00;00;00;00;00;00;00;00;00;08;00;10;01;01;01;10;00;00;00;00;00;07;00;00;00;00;00;00;00;00;00;00;00;00;00;00;00;00;00;08;00;00;00;00;08;17;17;17;00;00;00;00;00;00;00;00;00;00;00;00;00;00;00;00;00
00;00;00;00;08;00;00;07;00;00;00;00;00;00;00;00;00;00;00;00;00;00;00;00;00;00;00;00;00;00;00;00;00;00;00;00;00;00;00;00;00;00;00;00;00;00;10;01;01;01;10;00;00;08;00;00;00;00;00;00;00;00;00;00;00;00;00;00;00;00;00;00;00;00;00;00;00;00;00;00;17;17;17;00;00;00;00;00;00;00;00;00;00;00;00;00;00;00;00;07
00;00;00;00;00;00;00;00;00;00;08;00;00;00;00;07;00;00;00;00;00;00;00;00;00;00;00;00;00;00;00;00;00;00;00;08;00;00;00;00;00;00;00;00;00;00;10;01;01;01;10;00;00;00;00;07;00;00;00;00;00;00;00;00;08;00;00;00;08;00;00;00;00;00;00;00;00;00;00;00;08;17;17;17;00;00;00;00;00;00;00;00;00;00;00;00;00;00;00;00
00;00;00;00;00;00;00;00;00;00;00;08;00;00;00;00;00;00;00;00;00;00;00;00;00;00;00;00;00;00;00;00;00;00;00;00;00;00;00;00;00;00;07;00;00;00;10;01;01;01;10;00;00;00;00;00;00;00;00;00;00;00;00;00;00;00;00;00;00;00;00;00;00;00;00;00;00;00;00;00;00;17;17;17;00;00;00;00;00;00;00;00;00;00;00;07;00;00;00;00
00;00;00;00;00;00;00;00;00;08;00;00;00;00;0;0;8;0;0;0;0;0;0;0;0;0;0;0;0;0;0;0;7;0;0;0;0;0;0;8;0;0;0;0;0;0;10;1;1;1;10;0;8;0;0;0;0;0;0;0;0;0;0;0;0;0;0;0;0;0;0;0;0;0;0;0;0;0;0;0;0;0;17;17;17;0;0;0;0;0;0;0;0;0;0;0;0;0;0;0
00;00;00;00;00;00;00;00;00;00;00;00;00;00;0;0;0;0;0;0;0;0;0;0;0;0;0;0;0;0;0;0;0;0;0;0;0;0;0;0;0;0;0;0;0;0;10;1;1;1;10;0;0;0;0;0;0;0;0;0;8;0;0;0;0;0;0;0;0;0;0;0;0;0;0;0;0;0;0;0;0;0;0;17;17;17;0;0;0;0;0;0;0;0;0;0;0;0;8;0
00;00;00;00;00;00;00;00;00;00;00;00;08;00;0;0;0;0;0;0;8;0;0;0;0;0;0;1;1;1;1;1;1;1;1;1;1;1;1;1;1;1;1;1;1;1;1;1;1;1;1;1;1;1;1;1;1;1;1;1;1;1;1;1;1;1;1;1;1;1;1;1;1;1;1;1;1;1;1;1;1;1;1;1;1;17;17;0;0;0;0;0;0;0;0;0;0;0;0;0
00;00;00;07;00;00;00;00;00;07;00;00;00;00;0;0;0;0;0;0;0;0;0;0;0;0;1;1;1;1;1;1;1;1;1;1;1;1;1;1;1;1;1;1;1;1;1;1;1;1;1;1;1;1;1;1;1;1;1;1;1;1;1;1;1;1;1;1;1;1;1;1;1;1;1;1;1;1;1;1;1;1;1;1;1;17;0;0;0;0;0;0;0;0;0;0;0;0;0;0
00;00;00;07;00;00;00;00;00;00;00;00;00;00;0;0;0;0;0;0;0;0;0;0;0;0;0;1;1;1;1;1;1;1;1;1;1;1;1;1;1;1;1;1;1;1;1;1;1;1;1;1;1;1;1;1;1;1;1;1;1;1;1;1;1;1;1;1;1;1;1;1;1;1;1;1;1;1;1;1;1;1;1;1;1;17;0;0;0;0;0;0;0;0;0;0;0;0;0;0
00;00;00;00;00;00;00;00;00;00;00;00;00;00;0;0;0;0;0;0;0;0;0;0;0;0;0;0;8;0;0;0;0;0;0;0;0;0;0;0;0;0;0;0;0;0;0;0;0;0;7;0;0;0;10;1;1;1;10;0;0;0;0;0;0;0;0;0;0;0;0;0;0;0;0;0;0;0;0;0;0;0;0;0;0;0;0;0;0;0;0;0;0;0;0;0;0;0;0;0
08;00;00;00;00;00;00;00;00;08;00;08;00;00;7;0;0;0;0;0;0;0;0;0;0;0;0;0;0;0;0;0;0;7;0;0;0;0;0;0;0;0;0;0;8;0;0;0;0;0;0;0;0;0;10;1;1;1;10;0;0;0;8;0;0;0;0;0;7;0;0;0;0;0;0;0;0;0;0;0;0;0;0;0;0;0;0;0;0;0;0;0;0;0;7;0;0;0;0;0;0
00;00;00;00;00;00;00;00;00;08;08;00;00;00;0;0;0;0;0;0;0;0;0;0;8;0;10;10;10;10;10;10;10;10;10;10;10;10;10;10;10;10;10;10;10;10;10;10;10;10;10;10;10;10;10;1;1;1;10;10;10;10;10;10;10;10;10;0;0;0;0;0;0;0;0;0;0;0;0;0;7;0;0;0;0;0;0;0;0;0;0;0;8;0;0;0;0;0;0;0
00;00;00;00;00;00;00;00;08;08;08;08;00;00;0;0;0;0;0;0;0;0;0;0;0;0;10;1;1;1;1;1;1;1;1;1;1;1;1;1;1;1;1;1;1;1;1;1;1;1;1;1;1;1;1;1;1;1;1;1;1;1;1;1;1;1;10;0;0;0;0;0;0;0;0;0;0;0;0;0;0;0;0;0;0;0;0;0;0;8;0;0;0;0;0;0;0;0;0;0
00;00;00;00;00;00;00;00;00;08;08;08;00;00;0;0;0;0;0;0;0;0;0;0;0;0;10;1;1;1;1;1;1;1;1;1;1;1;1;1;1;1;1;1;1;1;1;1;1;1;1;1;1;1;1;1;1;1;1;1;1;1;1;1;1;1;10;0;0;7;0;0;0;0;0;0;0;0;0;0;0;0;0;0;0;0;0;0;0;0;0;0;0;0;0;0;0;0;0;0
00;00;00;00;00;00;00;00;00;00;08;00;00;00;0;0;0;0;0;0;0;0;0;8;0;0;10;1;1;1;1;1;1;1;1;1;1;1;1;1;1;1;1;1;1;1;1;1;1;1;1;1;1;1;1;1;1;1;1;1;1;1;1;1;1;1;10;0;0;0;0;0;0;0;0;0;0;0;7;0;0;0;0;0;0;0;0;0;0;0;0;0;0;0;0;0;0;0;0;0
00;00;00;00;00;00;00;00;00;00;00;00;00;00;0;0;0;0;0;8;0;0;0;0;0;0;10;1;1;1;10;10;10;10;10;10;10;10;10;10;10;10;10;10;10;10;10;10;10;10;10;10;10;10;10;10;10;10;10;10;10;10;10;1;1;1;10;0;0;0;0;0;0;0;0;0;0;0;0;0;0;0;0;0;0;0;0;0;0;0;0;0;0;0;0;0;0;0;0;0
00;00;00;00;07;00;00;00;00;00;00;00;00;08;0;0;0;0;0;0;0;0;0;0;0;0;10;1;1;1;10;0;0;0;0;0;0;0;0;0;0;0;0;0;0;0;0;0;0;0;0;0;0;0;0;0;8;0;0;0;0;0;10;1;1;1;10;0;0;0;8;0;0;0;0;0;0;0;0;0;0;0;8;0;0;0;7;0;0;0;0;0;0;0;0;0;0;0;0;0
00;00;00;00;00;00;00;00;00;00;00;00;00;00;0;0;0;0;0;0;0;0;0;3;3;3;3;3;5;3;3;3;3;3;0;0;0;0;0;0;0;0;0;0;8;0;0;0;0;0;0;0;0;0;0;0;0;0;0;0;0;0;10;1;1;1;10;0;0;0;0;0;0;0;0;8;0;0;0;0;0;0;0;0;0;0;0;0;0;0;0;0;0;0;0;0;0;0;0;0
00;00;00;00;00;00;00;07;00;00;00;00;00;00;0;0;0;0;0;0;0;0;0;3;5;5;5;5;5;5;5;5;5;3;0;0;0;0;0;0;0;0;0;0;0;0;0;0;0;0;0;0;0;0;0;0;0;3;3;3;3;3;3;3;5;3;3;3;3;3;3;3;0;0;0;0;0;0;0;0;0;0;0;0;0;0;0;0;0;0;0;0;0;0;0;0;0;0;0;0
00;00;00;00;00;00;00;00;00;00;07;00;00;00;0;0;0;0;8;0;0;0;0;3;5;5;5;5;5;5;5;5;5;3;0;0;0;0;0;0;0;8;0;0;0;0;0;0;0;8;0;0;0;0;0;0;0;3;14;15;16;5;5;5;5;5;5;5;5;5;5;3;0;7;0;0;0;0;0;7;0;0;0;0;0;0;0;0;0;0;0;0;0;0;0;0;0;0;0;0
00;00;00;00;00;00;00;00;00;00;00;00;00;00;0;0;0;8;0;0;0;0;0;3;5;5;5;5;5;5;5;5;5;3;0;0;0;0;0;0;0;0;7;0;0;0;0;0;0;0;0;0;0;0;0;0;0;3;5;5;5;5;5;5;5;5;5;5;5;5;5;3;0;0;0;0;0;0;0;0;0;0;0;0;0;0;0;0;0;0;0;0;0;0;0;0;0;0;0;0
00;00;00;00;00;00;00;00;00;00;00;00;00;00;0;0;0;0;0;0;0;0;0;3;5;5;5;5;5;5;5;5;5;3;0;0;0;0;0;0;0;0;0;0;0;0;0;0;0;0;0;0;0;0;0;0;0;3;5;5;5;5;5;5;5;5;5;5;5;5;5;3;0;0;0;0;0;0;0;0;0;0;0;0;0;0;8;0;0;0;0;0;0;0;0;0;0;0;0;0
00;00;00;00;08;00;00;00;00;00;00;00;00;08;0;0;0;0;0;0;0;0;0;3;5;5;5;5;5;5;5;5;5;3;0;0;0;0;0;0;0;0;0;0;0;0;0;0;0;0;0;0;0;0;0;0;0;3;5;5;5;5;5;5;5;5;14;15;14;16;14;3;0;0;0;8;0;0;0;0;0;0;0;0;0;0;0;0;0;0;0;0;0;0;0;0;0;0;0;0
00;00;00;00;00;00;00;00;00;00;00;00;00;00;0;0;0;0;0;0;0;0;0;3;14;15;16;5;5;5;5;5;5;3;0;0;0;0;0;0;0;0;0;0;0;0;0;0;0;8;0;0;0;0;0;0;0;3;5;5;5;5;5;5;5;5;5;5;5;5;5;3;0;0;0;0;0;0;0;0;0;0;0;0;0;0;0;0;0;0;0;0;0;0;0;7;0;0;0;0
00;00;07;00;00;00;00;00;00;00;00;00;00;00;0;0;0;0;0;0;8;0;0;3;5;5;5;5;5;5;5;5;5;3;0;0;0;0;0;0;0;0;0;0;8;0;0;8;0;0;0;0;0;0;0;0;0;3;5;5;5;5;5;5;5;5;5;5;5;5;5;3;0;0;0;0;0;0;0;0;0;0;0;0;0;0;0;0;0;0;0;0;0;0;0;0;0;0;0;0
00;00;00;00;00;00;00;00;08;00;00;00;00;00;0;0;0;0;0;0;0;0;0;3;5;5;5;5;5;5;5;5;5;3;0;0;0;0;0;0;0;0;0;0;0;0;8;8;8;0;0;0;0;0;0;0;0;3;5;5;5;5;5;5;5;5;5;5;5;5;5;3;0;8;0;0;0;0;0;0;0;0;0;0;0;0;0;0;0;0;0;0;0;0;0;0;0;0;0;0
00;00;00;00;00;00;00;00;00;00;00;00;00;00;0;0;7;0;0;0;0;0;0;3;5;5;5;5;5;5;5;5;5;3;0;0;0;0;7;0;0;0;0;0;0;8;8;8;0;0;0;0;0;0;0;0;0;3;5;5;5;5;5;5;5;5;5;5;5;5;5;3;0;0;0;0;0;0;0;0;0;0;0;0;0;7;0;0;0;0;0;0;0;0;0;0;0;0;0;0
00;00;00;00;00;00;00;00;00;00;00;00;00;00;0;0;7;7;0;0;0;0;0;3;5;5;5;5;5;5;5;14;16;3;0;0;0;0;0;0;0;0;0;0;0;0;8;0;0;0;0;0;0;0;0;0;0;3;3;3;3;3;3;3;3;3;3;3;3;3;3;3;0;0;0;0;0;0;0;0;0;0;0;0;0;0;0;0;0;0;0;0;0;0;0;0;0;0;0;0
00;00;00;00;00;00;00;00;00;00;08;00;00;00;7;0;0;0;0;7;0;0;0;3;5;5;5;5;5;5;5;5;5;3;0;0;0;0;0;0;0;0;0;0;0;0;0;8;0;0;0;0;0;0;0;0;0;0;0;0;0;0;0;0;0;0;0;0;0;0;0;0;0;0;0;0;0;0;0;0;8;0;0;0;0;0;0;0;0;0;7;0;0;0;0;0;0;0;0;0
00;00;00;00;00;00;00;00;00;08;00;00;00;00;0;0;0;0;0;0;0;0;0;3;5;5;5;5;5;5;5;5;5;3;7;0;0;0;0;8;0;0;7;0;0;0;0;0;0;0;0;0;0;0;0;7;0;0;0;0;0;8;0;0;0;0;0;0;0;0;0;0;8;0;0;8;0;0;0;0;0;0;0;0;8;0;0;0;0;0;0;0;0;0;8;0;0;0;0;0
00;00;00;00;08;00;00;00;00;00;00;00;00;00;0;0;0;0;0;0;0;0;0;3;3;3;3;3;3;3;3;3;3;3;0;0;0;0;0;0;0;8;0;0;0;0;0;0;0;0;0;0;0;0;0;0;0;0;0;0;0;0;0;0;0;0;7;0;0;0;0;0;0;0;0;0;0;0;0;0;0;0;0;0;0;0;0;0;0;0;0;0;0;0;0;0;0;0;0;0
00;00;00;00;00;00;00;00;00;00;00;00;00;00;0;0;0;0;7;0;0;0;0;0;0;0;0;0;0;0;0;0;0;0;0;0;0;0;0;0;0;0;0;0;0;0;0;0;0;0;0;8;0;0;8;0;8;0;0;0;8;0;0;0;0;0;0;0;0;0;0;0;0;0;0;0;0;0;7;0;0;0;0;0;0;0;0;0;0;0;0;0;0;0;0;0;0;0;0;0
00;00;00;00;00;00;00;00;00;00;00;00;00;00;0;0;0;0;0;0;0;0;0;0;0;0;0;0;0;0;0;0;0;8;0;0;0;0;7;0;0;0;0;0;0;0;0;0;0;0;8;0;0;0;0;0;0;0;8;0;0;0;0;0;0;0;0;0;8;0;0;0;0;0;0;7;0;0;0;0;0;0;0;0;0;0;0;0;8;0;0;0;0;0;0;0;0;0;0;0
00;00;00;00;00;00;00;00;00;00;00;00;00;00;0;0;0;0;0;0;0;0;0;0;0;0;0;8;0;0;0;0;0;0;0;0;0;0;0;0;0;0;0;7;0;0;0;0;0;0;0;0;0;0;0;0;0;0;0;0;0;0;0;0;0;0;0;0;0;0;0;0;0;0;0;0;0;0;0;0;0;0;0;0;0;0;0;0;0;0;0;0;0;0;7;0;0;0;0;0
00;00;00;00;00;00;00;00;00;00;00;00;00;00;0;0;0;0;0;0;0;0;0;0;0;0;8;0;0;0;0;0;0;0;0;8;0;0;0;0;0;0;0;0;0;0;7;0;0;0;0;0;0;0;0;0;0;0;0;0;0;0;0;0;0;0;0;0;0;0;0;0;0;0;0;0;7;0;0;0;0;0;0;0;0;0;0;0;0;0;0;0;0;0;0;0;0;0;0;0
00;00;00;00;00;00;00;08;00;00;00;00;00;00;0;0;0;0;0;0;0;0;0;0;0;0;0;0;0;0;0;0;0;0;0;0;0;0;0;0;0;0;0;0;0;0;0;0;0;0;0;0;0;0;7;0;0;0;0;0;0;0;7;0;0;0;0;0;0;0;0;0;0;0;0;0;0;0;8;0;0;0;0;0;0;0;0;0;0;0;0;0;0;0;0;0;0;0;0;0
00;00;00;00;00;00;00;00;00;00;00;00;00;00;0;0;7;0;0;0;0;0;0;8;0;0;0;0;0;0;0;0;0;0;0;8;0;0;0;0;0;8;0;0;0;0;0;0;0;0;0;0;0;0;0;0;0;0;0;0;7;0;7;0;7;0;0;0;0;0;0;0;0;0;0;0;0;0;0;0;0;0;0;0;0;0;0;0;0;0;0;0;0;0;0;0;0;0;0;0
00;00;00;00;00;00;00;00;00;00;00;00;00;00;0;0;0;0;0;0;0;0;0;0;0;0;0;0;0;7;0;0;0;0;0;0;0;0;0;0;0;0;0;0;0;0;8;0;0;0;8;0;0;0;0;0;0;0;0;0;0;0;0;0;7;7;0;0;0;0;0;0;0;0;7;0;0;0;0;0;0;0;0;0;0;0;0;0;0;0;0;0;0;0;0;0;0;0;0;0
00;00;00;00;00;00;00;00;00;00;00;00;07;00;0;0;0;0;0;0;0;0;0;0;0;0;0;0;0;0;7;0;0;0;0;0;0;0;0;0;0;0;0;0;0;0;0;0;0;0;0;0;0;0;0;0;0;0;0;0;0;0;0;7;7;7;0;0;0;0;0;0;0;8;0;0;0;0;0;0;0;8;0;0;0;0;0;0;0;0;0;0;0;0;0;0;0;0;0;0
00;00;00;00;00;08;00;00;00;00;00;00;00;00;0;0;0;0;0;0;0;0;0;0;0;0;0;0;0;0;0;0;0;0;0;0;0;0;0;8;0;0;0;0;0;0;0;8;0;7;0;0;0;0;0;0;0;0;0;0;0;0;0;0;7;0;0;0;0;0;0;0;0;0;0;0;0;0;0;0;0;0;0;0;0;0;0;0;0;0;0;0;0;0;0;0;0;0;0;0
00;00;00;00;00;00;00;00;00;00;00;00;00;00;0;0;8;0;0;0;0;0;0;0;0;0;0;0;0;0;0;0;0;0;0;0;0;0;7;0;0;0;0;0;0;0;0;0;0;0;0;0;0;0;0;0;0;8;0;0;0;0;0;0;0;0;0;0;0;0;0;0;0;0;0;0;0;0;0;0;8;0;0;0;0;0;0;0;0;0;7;0;0;0;0;0;0;0;0;0
00;00;00;00;00;00;00;00;00;00;00;00;00;00;0;0;0;0;0;0;8;0;0;0;0;0;0;0;0;0;0;0;0;0;0;0;0;0;0;0;0;0;0;0;0;0;0;0;0;0;0;0;0;0;0;0;0;0;0;0;0;0;0;0;0;0;0;0;0;0;8;0;0;0;0;0;0;0;0;0;0;0;0;0;0;0;0;0;0;0;0;0;0;0;0;0;0;0;0;0
00;00;00;00;00;00;00;00;00;00;00;00;00;00;0;0;0;0;0;0;0;0;0;0;0;0;0;0;0;0;0;0;0;0;0;0;0;0;0;0;0;0;0;0;0;8;0;0;0;0;0;0;0;0;0;0;0;0;0;0;0;0;8;0;0;0;0;0;0;0;0;0;0;0;0;0;0;0;0;0;0;0;0;0;0;0;0;0;0;0;0;0;0;0;0;0;0;0;0;0
00;00;00;00;00;00;00;00;00;00;00;00;00;00;0;0;8;0;8;0;0;0;0;0;0;0;0;0;0;0;0;0;0;0;0;7;0;0;0;0;0;0;0;0;8;0;0;0;0;0;0;0;0;7;0;0;0;0;0;0;0;0;0;0;0;0;0;0;0;0;0;0;0;7;0;0;0;0;0;0;0;0;0;0;0;0;0;0;0;0;0;0;0;0;0;0;0;0;0;0
00;00;00;00;00;00;00;00;07;00;00;00;00;00;0;0;0;0;0;0;0;0;0;0;0;0;0;0;0;0;0;0;0;0;0;0;0;0;0;0;0;0;0;0;0;0;0;0;0;0;0;0;0;0;0;0;0;0;0;0;8;0;0;0;0;0;0;0;0;0;0;0;0;0;0;0;0;0;0;0;0;0;0;0;0;8;0;0;0;0;0;0;0;0;0;0;0;0;0;0
00;00;00;00;00;00;00;00;00;00;00;00;08;00;0;0;0;0;0;0;0;0;0;0;0;0;0;0;0;0;0;0;0;0;0;0;0;0;0;0;8;0;0;0;0;0;0;0;0;7;0;0;0;0;0;0;0;0;0;0;0;0;0;0;0;0;0;0;0;0;0;0;0;0;0;0;0;0;0;0;0;7;0;0;0;0;0;0;0;0;0;0;0;0;0;0;0;0;0;0
00;00;00;00;00;08;00;00;00;00;00;00;00;00;8;0;0;0;0;0;0;0;0;0;7;0;0;0;0;0;0;0;0;0;0;0;0;0;8;0;0;0;0;0;0;0;0;0;0;0;0;0;0;0;0;0;0;0;0;0;0;0;0;0;0;0;7;0;0;0;0;0;0;0;0;0;0;0;0;0;0;0;0;0;0;0;0;0;0;0;0;0;0;0;0;0;0;0;0;0
00;00;00;00;00;00;00;00;00;00;00;00;00;00;0;0;0;0;0;0;0;0;0;0;0;0;0;0;0;0;0;0;0;0;0;0;0;0;0;0;0;0;0;0;0;0;0;0;0;0;0;0;0;0;0;0;0;0;0;0;8;0;0;8;0;0;0;0;0;0;0;0;0;0;0;0;0;0;0;0;0;0;0;0;0;0;0;7;0;0;0;0;0;0;0;0;0;0;0;0
00;00;00;00;00;00;00;00;07;00;00;00;00;00;0;0;0;0;0;0;0;0;0;0;0;0;0;0;0;0;0;0;0;0;0;0;0;0;0;0;0;0;0;0;0;0;0;0;0;0;0;0;0;0;0;0;0;0;0;0;0;0;0;0;0;0;0;0;0;0;0;0;0;0;0;0;0;8;0;0;0;0;0;0;0;0;0;0;0;0;0;8;0;0;0;0;0;0;0;0
00;00;00;00;00;00;00;00;00;00;00;00;00;00;0;0;0;0;0;0;0;0;8;0;0;0;0;0;7;0;0;0;0;0;0;0;0;0;0;0;0;0;0;0;0;0;0;0;0;0;0;0;0;0;0;0;0;0;0;0;0;8;0;0;0;0;0;0;0;0;0;0;0;0;0;0;0;0;0;0;0;0;0;0;0;0;0;0;0;0;0;0;0;0;0;0;0;0;0;0
00;00;00;00;00;00;00;00;00;00;00;00;00;00;0;0;0;0;0;0;0;0;0;0;0;0;0;0;0;0;0;0;0;0;0;0;0;0;0;0;0;7;0;0;0;0;0;0;0;0;0;0;0;0;0;0;0;0;0;0;0;0;0;0;0;0;0;0;0;0;0;0;0;0;0;0;0;0;0;0;0;0;0;8;0;0;0;0;0;0;0;0;0;0;0;0;0;0;0;0
00;00;00;00;00;00;00;00;00;00;00;00;00;00;0;0;8;0;0;0;0;0;0;0;0;0;0;0;0;0;0;0;0;0;8;0;0;0;0;0;0;0;0;0;0;0;0;0;0;0;0;0;0;0;0;0;0;0;0;0;0;0;0;0;0;0;0;0;0;0;0;0;0;0;0;0;0;0;0;0;0;0;0;0;0;0;0;0;8;0;0;0;0;0;0;0;0;0;0;0
00;00;00;00;00;00;00;00;00;00;00;00;00;00;0;8;0;0;0;0;0;0;0;0;0;0;0;0;0;0;0;0;0;0;0;0;0;0;0;0;0;0;0;0;0;0;0;0;0;0;0;0;0;0;0;0;0;0;0;0;0;0;0;0;0;0;0;0;0;0;0;0;0;0;0;0;0;0;0;0;0;0;0;0;0;0;0;0;0;0;0;0;0;0;0;0;0;0;0;0
00;00;00;00;00;00;00;00;00;00;07;00;00;00;0;0;0;0;0;0;0;0;0;0;0;0;0;0;0;0;0;0;0;0;0;0;0;0;0;0;0;0;0;0;0;0;0;0;0;0;0;0;0;8;0;0;0;0;0;0;0;0;0;0;0;0;0;0;0;0;0;0;0;0;0;7;0;0;0;0;0;0;0;0;0;0;0;0;0;0;0;0;0;7;0;0;0;0;0;0
00;00;00;00;00;00;00;00;00;00;00;00;00;00;0;0;0;0;0;0;0;0;0;0;0;0;0;0;0;0;0;0;7;0;0;0;0;0;8;0;0;0;0;0;0;0;0;0;0;0;0;0;0;0;0;0;0;0;0;7;0;0;0;0;0;0;0;0;0;0;0;0;0;0;0;0;0;0;8;0;0;0;0;0;0;0;0;0;0;0;0;0;0;0;0;0;0;0;0;0
00;00;00;00;00;00;00;00;00;00;00;00;00;00;0;0;0;0;0;0;0;0;0;0;0;0;0;0;0;0;0;0;0;0;0;0;0;0;0;0;0;0;0;0;0;0;0;0;0;0;0;0;0;0;0;0;0;0;0;0;0;0;0;0;0;0;0;0;0;0;0;0;0;0;0;0;0;0;0;0;0;0;0;0;0;0;0;0;0;0;0;0;0;0;0;0;0;0;0;0
00;00;00;00;00;00;00;00;00;00;00;00;00;00;00;00;00;00;00;07;00;00;00;00;00;00;00;00;00;00;00;00;00;00;00;00;00;00;00;00;00;00;00;00;00;00;00;00;00;00;00;00;00;00;00;00;00;00;00;00;00;00;00;00;00;00;00;08;00;00;00;00;00;00;00;00;00;00;00;00;00;00;00;00;00;00;00;00;00;00;00;00;00;00;00;00;00;00;00;00
00;00;00;00;00;00;00;00;00;00;00;00;00;00;00;08;00;00;00;00;00;00;00;00;00;00;00;00;00;00;00;00;00;00;00;00;00;00;00;00;00;00;07;00;00;00;00;00;00;00;00;00;00;00;00;00;00;00;00;00;00;00;00;00;00;00;00;00;00;00;00;00;00;00;00;00;00;08;00;00;00;00;00;00;00;07;00;00;00;00;00;00;00;00;00;00;07;00;00;00
00;00;00;00;00;00;00;00;00;00;00;00;08;00;00;00;00;00;00;00;00;00;00;00;00;00;00;00;00;00;00;00;00;00;00;00;00;00;00;00;00;00;00;00;00;00;00;00;00;00;00;00;00;00;00;00;00;00;00;00;00;00;00;00;00;00;00;00;00;00;00;00;00;00;00;00;00;00;00;00;00;00;00;00;00;00;00;00;00;00;00;00;00;00;00;00;00;00;00;00
00;00;00;00;00;00;00;00;00;00;00;00;00;00;00;00;00;00;00;00;00;00;00;00;00;00;00;00;00;00;00;00;00;00;00;08;00;00;00;00;00;00;00;00;00;00;00;00;00;00;08;00;00;00;00;00;00;00;00;00;00;00;00;00;00;00;00;00;00;00;00;00;00;00;00;00;00;00;00;00;00;00;00;00;00;00;00;00;00;00;00;00;00;08;00;00;00;00;00;00
00;00;00;00;07;00;00;00;00;00;00;00;00;00;00;00;00;00;00;00;08;00;00;00;00;00;00;08;00;00;00;00;00;00;00;00;00;00;00;00;00;00;00;00;00;00;07;00;00;00;00;00;00;00;00;00;00;00;00;00;00;00;00;00;08;00;00;00;00;00;00;00;00;00;00;00;00;00;00;00;00;00;00;00;00;00;00;00;00;00;00;00;00;00;00;00;00;00;00;00
00;00;08;00;00;00;00;00;00;00;00;00;00;00;00;00;00;00;08;00;00;00;00;00;00;00;00;00;00;00;00;08;00;00;00;00;00;00;00;00;00;00;00;00;00;00;00;00;00;00;00;00;00;00;00;00;00;00;08;00;00;00;00;00;00;00;00;00;00;00;00;00;00;00;00;00;00;00;00;00;00;00;00;00;00;00;00;00;00;00;00;00;00;00;00;00;00;08;00;00
00;00;00;00;00;00;00;00;00;00;00;00;00;00;00;00;00;00;00;00;00;00;00;00;00;00;00;00;00;00;00;00;00;00;00;08;00;00;00;00;00;00;00;00;00;00;00;00;00;00;08;00;00;00;00;00;00;00;00;00;00;00;00;00;00;00;00;00;00;00;00;00;00;00;00;00;00;00;00;00;00;00;00;00;00;00;00;00;00;00;00;00;00;08;00;00;00;00;00;00
00;00;00;00;07;00;00;00;00;00;00;00;00;00;00;00;00;00;00;00;08;00;00;00;00;00;00;08;00;00;00;00;00;00;00;00;00;00;00;00;00;00;00;00;00;00;07;00;00;00;00;00;00;00;00;00;00;00;00;00;00;00;00;00;08;00;00;00;00;00;00;00;00;00;00;00;00;00;00;00;00;00;00;00;00;00;00;00;00;00;00;00;00;00;00;00;00;00;00;00
00;00;08;00;00;00;00;00;00;00;00;00;00;00;00;00;00;00;08;00;00;00;00;00;00;00;00;00;00;00;00;08;00;00;00;00;00;00;00;00;00;00;00;00;00;00;00;00;00;00;00;00;00;00;00;00;00;00;08;00;00;00;00;00;00;00;00;00;00;00;00;00;00;00;00;00;00;00;00;00;00;00;00;00;00;00;00;00;00;00;00;00;00;00;00;00;00;08;00;00